1111111111111111111111111111111111111111
1000000000000000000000000000000000000001
1000000000000000000000000000000000000001
1000000000000000000000000000000000000001
1000000000000000000000000000000000000001
1000010101011111111111111111111111100001
1000010000000000000000000000000000100001
1000010000000000000000000000000000100001
1000010000000000000000000000000000100001
1000010000000000000000000000000000100001
1000010000000000000000000000000000100001
1000010000000000000000000000000000100001
1000010000000000000000000000000000100001
100001000000000000000000000000000F100001
1000011111111111111111111111111111100001
1000000000000000000000000000000000000001
1000000000000000000000000000000000000001
1000000000000000000000000000000000000001
10000000000000000000000000000000000000S1
1111111111111111111111111111111111111111
